77000000000000-
07077700777000-
07070700707000-
07070700707000-
07070700707770-
07070700700000-
07770777700000-
00000000000000-
00000000000000
